bbbbbbbbbbbbbbbbbbbbbbbbbbbbbbbbbbbbbbbbbbbbbbbbbbbbbbbbbbbbbbbbbbbbbbbbbbbbbbbbbbbbbbbbbbbbbbbbbbbb
b00000000000000000000000000000000000000000000000000000000000000000000000000000000000000000000000000b
b00000000000000000000000000000000000000000000000000000000000000000000000300000000000000000000000000b
b00000000000000000000000000000000000000033300000000000000000000000000000230000000000000000000000000b
b00000000000000000000000000000000000000322200000000000000000000000000000220000000000000000000000000b
b00000000000000000000000000000000000003221200000000000000000000000000000220000000000000000000000000b
b00000000000000000000000000000000000002211000000000000000000000000000000220000000000000000000000000b
b00000000000000000000000000000000000000110000000000000000000000000000000220000000000000000000000000b
b00000000000000000000000000000000000000010000000000000000000030000000000220000000000000000000000000b
b00000000000000000000000000000000000000010000000000000000000323000000032123300000000000000000000000b
b00000000000000000000000000000330000000000000000000000000003222000000022112200000000000000000000000b
b00000000000000000000000000003223000000000000000000000000032110000000000111000000000000000003333300b
b33000000000000000000000000002122000000000000000000000333321100000000000010000000000000033332222200b
b22300000000000000000000000002110000000010000030000003222221000000000000000000000000000322221111000b
b12230000000000000000030000000100000000310000323300002111110000033333000000000000000000221111110003b
b112233300sss00000000323300000000000033210000212200000011100000322222300000000000000000211111000032b
b11122223333333000000212200000000000322110000011000000001000000221111200000333333333300000000000022b
b11111122222222300000021200000000000221110000001000000001000000011100000003222222222233000000000112b
b11111111111111200000001000000000000211110000000000000000000000001000000002111111111122221111111111b
bbbbbbbbbbbbbbbbbbbbbbbbbbbbbbbbbbbbbbbbbbbbbbbbbbbbbbbbbbbbbbbbbbbbbbbbbbbbbbbbbbbbbbbbbbbbbbbbbbbb
