bbbbbbbbbbbbbbbbbbbbbbbbbbbbbbbbbbbbbbbbbbbbbbbbbbbbbbbbbbbbbbbbbbbbbbbbbbbbbbbbbbbbbbbbbbbbbbbbbbbb
b00000000000000000000000000000000000000000000000000000000000000000000000000000000000000000000000000b
b00000000000000000000000000000000000000000000000000000000000000000000000000000000000000000000000000b
b00000000000000000000000000000000000000000000000000000000000000000000000000000000000000000000000000b
b00000000000010000000000000000000000000000000000000000000000000000000000000000000000000000000000000b
b00000000000000000002211222220000000000000000000000000000000000000000000000000000000000000000000000b
b00000000000000022222222222210000000000100000100000000000000100000000001000000000000000000000000000b
b00000100000000222222220112222220000000000000000000000000000000000000000000000000000000100000000000b
b00000001000002222022020312222210000000000000000000001000000000000000000000000000000000000000000000b
b00010000000222221121220311110211111000000000000000000000000000000000000000000000000000000000000000b
b00000000002222201001032333311333111000000000000000000000000000000000000000000001000001000000030000b
b00000000222020101333333113301111001000000000000000000000000000000000000000000000000000000003333000b
b33333333333333333333330010333101102222222220000000000000000000000000000000000000000000000033333300b
b00000000030311331311030010000100100011111022222200000033333000000000000000000000000000000333333333b
b00000000000000131333131110011101111111101100000111111131113111111111111111110000000000033333333333b
b00000000000000000003333103100011111111111111111110000000000000000000000000011111111111112222222112b
b00000000000000000000011100000303033000110011000011100000000000000000000000000000000000011111111111b
b00000000000000000000000000000000003000000000110000110000000000000000000000000000000000000000000000b
b00000000000000000000000000000000000000000000011111100000000000000000000000000000000000000000000000b
bbbbbbbbbbbbbbbbbbbbbbbbbbbbbbbbbbbbbbbbbbbbbbbbbbbbbbbbbbbbbbbbbbbbbbbbbbbbbbbbbbbbbbbbbbbbbbbbbbbb
