0000000000000000000000000000000000000000000000000000
0000000000000000000000000000000000000000000000000000
0000000000000000000000000000000000000000000000000000
0000000000000000000000000000000000000000000000000000
0000000000000000000000000000000000000000000000000000
0000000000000000000000000000000000000000000000000000
0000000000000000000000000000000000000000000000000000
0000000000000000000000000000000000000000000000000000
0000000000000000000000000000000000000000000000000000
0000000000000000000000000000000000000000000000000000
0000000000000000000000003333333330000000000000000000
3000000000000000000000002222222220000000000000000000
2333000000000000000000000000000000000000000000000000
2222300000000000000000000000000000000000000000000000
1222233333333333333333333333333333333333000003333300
1122222222222222222222222222222222222222000002222200
1111222222222222222222222222222222222222000002212000
1111111111222221111111122211111111111221000002112000
1111111111111111111111111111111111111111000000110000