bbbbbbbbbbbbbbbbbbbbbbbbbbbbbbbbbbbbbbbbbbbbbbbbbbbbbbbbbbbbbbbbbbbbbbbbbbbbbbbbbbbbbbbbbbbbbbbbbbbb
b00000000000000000000000000000000000000000000000000000000000000000000000000000000000000000000000000b
b00000000000000000000000000000000000000000000000000000000000000000000000000000000000000000000000000b
b00000000000000000000000000000000000000000000000000000000000000000000000000000000000000000000000000b
b00000000000000000000000000000000000000000000000000000000000000000000000000000000000000000000000000b
b00000000000000000000000000000000000000000000000000000000000000000000000000000000000000000000000000b
b00000111000000000000000000000000000000000000000000000000000000000000000000000000000000000000000000b
b01111101000033030030300330000000000000000000000000000000000000000000000000000000100001010100000000b
b01001111000000000000000003000000000000000000000001001010110001001000000000010111100000000111000000b
b01001011100000000000030030300000000000000000000000000000011000000010000101000001100000010111111100b
b01011110111000000030300000303000000000002220210222000000010000000001000010000101000010000000110100b
b11110011100000000033333033000303333022022110101111100000000000011000001001010000001000000000010110b
b11000011000000000000000000000000001001021000002020101001000000011111111010000000110000000101100010b
b11000110000010101011010110100100000110011120210000000000011100000000001000000000011111010000000000b
b00000011110100000000000000000000000000000110101001000100000100000000001100000000000000000000000000b
b00000000000000000000000000000000000000000000000000000000000000000000000011110000000000000000000000b
b00000000000000000000000000000000000000000000000000000000000000000000000000000000000000000000000000b
b00000000000000000000000000000000000000000000000000000000000000000000000000000000000000000000000000b
b00000000000000000000000000000000000000000000000000000000000000000000000000000000000000000000000000b
bbbbbbbbbbbbbbbbbbbbbbbbbbbbbbbbbbbbbbbbbbbbbbbbbbbbbbbbbbbbbbbbbbbbbbbbbbbbbbbbbbbbbbbbbbbbbbbbbbbb
