bbbbbbbbbbbbbbbbbbbbbbbbbbbbbbbbbbbbbbbbbbbbbbbbbbbbbbbbbbbbbbbbbbbbbbbbbbbbbbbbbbbbbbbbbbbbbbbbbbbb
b00000000000000000000000000000000000000000000000000000000000000000000000000000000000000000000000000b
b00000000000000000000000000000000000000000000000000000000000000000000000000000000000000000000000000b
b00000000000000000000000000000000000000000000000000000000000000000000000000000000000000000000000000b
b00000000000000000000000000000000000000000000000000000000000000000000000000000000000000000000000000b
b00000000000000000000000000000000000000000000000000000000000000000000000000000000000000000000000000b
b00000000000000000000000000000000000000000000000000000000000000000000000000000000000000000000000000b
b00000000000000000000000000000000000000000000000000000000000000000000000000000000000000000000000000b
b00000000000000000000000000000000000000000000000000000000000000000000000000000000000000000000000000b
b00000000000000000000000000000000000000000000000000000000000000000000000000000000000000000000000000b
b33300000000000000000000000000000000000000000000000000000000000000000000000000000000000000000000000b
b22230000000000000000000000000000000000000000000000000000000000000000000000000000000000000000000000b
b1222330000000ssss000000000000000000000000000000000000000000000000000000000000000000000000000000000b
b11222233333333333333300000000000000000000000000000000000000000000000000000000000000000000000000000b
b11112222222222222222230000000000000000000000000000000000000000000000000000000000000000000000000000b
b11111112221122222222220000000000000000000000000000000000000000000000000000000000000000000000000000b
b11111111111111122211220000000000000000000000000000000000000000000000000000000000000000000000000000b
b11111111111111111111120000000000000000000000000000000000000000000000000000000000000000000000000000b
b11111111111111111111120000000000000000000000000000000000000000000000000000000000000000000000000000b
bbbbbbbbbbbbbbbbbbbbbbbbbbbbbbbbbbbbbbbbbbbbbbbbbbbbbbbbbbbbbbbbbbbbbbbbbbbbbbbbbbbbbbbbbbbbbbbbbbbb
