bbbbbbbbbbbbbbbbbbbbbbbbbbbbbbbbbbbbbbbbbbbbbbbbbbbbbbbbbbbbbbbbbbbbbbbbbbbbbbbbbbbbbbbbbbbbbbbbbbbb
b00000000000000000000000000000000000000000000000000000000000000000000000000000000000000000000000000b
b00000000000000000000000000000000000000000000000000000000000000000000000000000000000000000000000000b
b0000000000000s000000000000000000000000000000000000000000000000000000000000000000000000000000000000b
b00000000000000000000000000000000000000000000000000000000000000000000000000000000000000000000000000b
b000sss00ss0000000000000000000000000000000000000000000000000000000000000000000000000000000000000000b
b3333333333300s000000000000000000000000000000000s00000000000000000000000000000000000000000000000000b
b00222222222003000000030s300000000000s000s000003330000000000000000000000000000000000000000000000000b
b002222222220033s0000s30030000000000330333300003033000000000000000000000000000000000000000000000000b
b00022222220s0033000033003000000000s300000000003003000000000000000000000000000000000000000000000000b
b00002222000000033s0030s03000000000000s0s0000003003000000000000000000000000000000000000000000000000b
b0000022000000000330s300030000000000030333300003033000000000000000000000000000000000000000000000000b
b00000020000s0000033330s030000000000300000000003330000000000000000000000000000000000000000000000000b
b000000200000000003330000300s0000000s00000000003330000000000000000000000000000000000000000000000000b
b00000020000000000000s0s03303333000s300000000003003000000000000000000000000000000000000000000000000b
b00000020000000330000000000033000s03033333333003003300000000000000000000000000000000000000000000000b
b000000200000033000s0000000000000300011111111003000300000000000000000000000000000000000000000000000b
b00000020000003003333333300000000000011111111000000000000000000000000000000000000000000000000000000b
b00000000000000000000000000333333300000000000000000000000000000000000000000000000000000000000000000b
bbbbbbbbbbbbbbbbbbbbbbbbbbbbbbbbbbbbbbbbbbbbbbbbbbbbbbbbbbbbbbbbbbbbbbbbbbbbbbbbbbbbbbbbbbbbbbbbbbbb
