bbbbbbbbbbbbbbbbbbbbbbbbbbbbbbbbbbbbbbbbbbbbbbbbbbbbbbbbbbbbbbbbbbbbbbbbbbbbbbbbbbbbbbbbbbbbbbbbbbbb
b00000000000000000000000000000000000000000000000000000000000000000000000000000000000000000000000000b
b00000000000000000000000000000000000000000000000000000000000000000000000000000000000000000000000000b
b00000033330000000000000000000000000000000000000000000000000000000000000000000000000000000000000000b
b00000021120000000000000000000000000000000000000000000000000000000000000000000000000000000000000000b
b00000021120000000000000000000000000000000000000000000000000000000000000000000000000000000000000000b
b00000033330000000000000000000000000000000000000000000000000000000000000000000000000000000000000000b
b00000021120000000000000000000000000000000000000000000000000000000000000000000000000000000000000000b
b00000021120000000000000000000000000000000000000000000000000000000000000000000000000000000000000000b
b00000021120000000000000000000000000000000000000000000000000000000000000000000000000000000000000000b
b00000021120000000000000000000000000000000000000000000000000000000000000000000000000000000000000000b
b00000021120000000000000000000000000000000000000000000000000000000000000000000000000000000000000000b
b00000000000000000000000000000000000000000000000000000000000000000000000000000000000000000000000000b
b33333322223333330000000000000000000000000000000000000000000000000000000000000000000000000000000000b
b21111200002111120000000000000000000000000000000000000000000000000000000000000000000000000000000000b
b21111200002111120000000000000000000000000000000000000000000000000000000000000000000000000000000000b
b21111200002111120000000000000000000000000000000000000000000000000000000000000000000000000000000000b
b22222200002222220000000000000000000000000000000000000000000000000000000000000000000000000000000000b
b00000000000000000000000000000000000000000000000000000000000000000000000000000000000000000000000000b
bbbbbbbbbbbbbbbbbbbbbbbbbbbbbbbbbbbbbbbbbbbbbbbbbbbbbbbbbbbbbbbbbbbbbbbbbbbbbbbbbbbbbbbbbbbbbbbbbbbb
